0000000000000000000000000000000000000000000000000000
0000000000000000000000000000000000000000000000000000
0000000000000000000000000000000000000000000000000000
0000000000000000000000000000000000000000000000000000
0000000000000000000000000000000000000000000000000000
0000000000000000000000000000000000000000000000000000
0000000000000000000000000000000000000000000000000000
000000000000000000000000ww00000000000w00000000000000
0000000000000000000000000w00000000000w00000000000000
0000000000000000000000000w0000wwwwww0ww0000000000000
0000000000000000000000000w0000w000000000000000000000
0000000000000000000000000wwwwww00ww0w000000000000000
000000000000000000000w0w000000ww00w0w000000000000000
000000000000000000000wIw0wwwwww00ww0w000000000000000
00000000000000000000w0w0000000w000w00000000000000000
0000000000000000000w0000000000wwwww0www0000000000000
000000000000000000w000000000000000000000000000000000
00000000000000000w0000000000000000000000000000000000
0000000000000000w00000000000000000000000000000000000
000000000000000w000000000000000000000000000000000000
00000000000000w0000000000000000000000000000000000000
0000000000000w00000000000000000000000000000000000000
000000000000w000000000000000000000000000000000000000
0000000wwwww0000000000000000000000000000000000000000
0000000w00w00000000000000000000000000000000000000000
0000000w00w0000000000000000000000000w000000000000000
0000000000w00000000000000000000000000ww0000000000000
0000000wwww0000000000000000000000000000w000000000000
00000000000w0000000000000000000000000000w00000000000
000000000000w000000000000w00000000000000w00000000000
0000000000000w00000000000w0000000000000w000000000000
00000000000000w0000000000w000000000000w0000000000000
000000000000000w000000000w00000000000w00000000000000
0000000000000000w00000000w000000000000w0000000000000
00000000000000000w0000000w0000000000000w000000000000
000000000000000000w000000w00000000000000w00000000000
0000w0000000000000w000000w000000000000000w0000000000
0000w000000000000w0000000w0000000000000000w000000000
00000w0000000000w00000000w00000000000000000w00000000
0000w0000000000w00000000ww00000000000000000000000000
wwwwwwwwwwwwwwww0wwwwwwwwwwwwwwwwwwwwwwwwwwwwwwwwwww
000000000w000000000000000w00000000000000000000000000
00000000w0000000000000000w00000000000000000000000000
0000000w00000000000000000w00000000000000000000000000
0000000w00000000000000000w00000000000000000000000000
0000000w00000000000000000000000000000000000000000000
00000000w0000000000000000wwwwwwwwwwwwwwwwwwwwwwww000
000000000w000000000000000w0000000000000000000000w000
00000000w0000000000000000w000000000000000000000w0000
0000000000000000000000000w00000000000000000000w00000
0000000w000000w0000000000w0000000000000000000w000000
00000000w0000w00000000000w000000000000000000w000000w
000000000wwww000000000000000000000000000000w00000ww0
0000000000w00000000000000w00wwww0000000000w0000ww000
00000000000w0000000000000w00w000w00000000w000ww00000
0000000000000000000000000w00w0000w000000w00ww0000000
0000000000000000000000000w00w00000w0000w00w000000000
0000000000000000000000000w00w000000w0000000000000000
0000000000000000000000000w00w0000000w000000000000000
0000000000000000000000000w00w00000000000000000000000
w0wwwwwwwwwwwwwwwwwwwwwwww00w00000000000000000000000
w0w0w000000000000000000000w00w0000000000000000000000
w0w0w0wwwwwwwwwwwwwwwwwww0w00w0000000000000000000000
w0w0w0000000000000000000w0w00ww000000000000000000000
w0w0w0wwwwwwwwwwwwwwwwwwwwwwwwwwwwwwwwwwwwwwwwwwwwww
w0w0w00000000000000000000000000000000000000000000000
w0w0wwwwwwwwwwwwwwwwwwwwwww0000000000000000000000000
00w0000000000000000000000w00000000000000000w00000000
00wwwwwwwww00000000000000w0000000000000000w000000000
00000000000000000000000000000000000000000w0000000000
000000000000w000000000000w00000000000000w00000000000
0000000000000w00000000000w0000000000000w000000000000
00000000000000w00000000000000000000000w0000000000000
000000000000000w000000000000000000000000000000000000
00000000000000000000ww00000wwwwwwwwwwwwwwwwwwwwwww00
000wwwww0wwww000000000ww0w000000000000000w0000000000
00000000www0www00000w00w0ww0wwwwwwwwwwwwwwwwwwwwwww0
00000000w00000w00000ww0w0wwww00000000000000000000000
00000000w0ww0ww000ww0w0w0000w00000000000000000w0w000
00000000w0ww0ww00000ww0w0wwwwwwww0000000000000w0w000
00000000w0ww0wwwwwwwww0w000000000wwwwwwww00000w0w000
00wwwwwww00000000000000ww0wwwwww000000000w0000w0w000
00000000w0ww0wwwwwwwwww0Oww00000wwwwwwww0w000w000w00
00000000w000000000000000ww00w0w0000000ww0w00w00000w0
000000000wwwwwwwwwwwwwww000wwwwwwwwww0ww0w0w0000000w
00000000000000000000ww000wwww0000w0ww0000ww000000000
0000000wwwwwwwww0000ww0w000ww00000www0ww0wwwwwwwwwww
00000000000000000000wwww0wwww000000ww0ww0wwwwwwwwwww
00wwwwwwwwwwwwwwwwww000w000ww000000ww0ww0wwwwwwwwwww
000000000wwwwwwwwwwwww0ww00www00000wwwwwwwwwwwwwwwww
000000000wwwwwwwww000000000ww00000000000000000000000
000000000wwwwwwwww0wwwwwwwww0wwwwwwwwwwwwwwwww000000
0000000000000000000000000000000000000000000000000000

