I0000w0000000w0000w0000000
00000w0000000w0000w00w0000
00000w0000000w0000w00w0000
00000w0000000w0000w00w0000
0000000000www00000w00w0000
wwwww0000000000000w00w0000
0000w0000www000000wwww0000
0000w0000www00000000000w00
0000w000000000000000000w00
0000w00000w000000ww000ww00
0000000000w000000w0000w00w
000000000ww00000wwwwwww00w
0000000000www000w00000000w
00000000000000000w0w00w00O